Bludiste03 Slova se mohou opakovat Zdar bude vypsan ctyrikrat
##############################
############## etseJ   #######
######    A    ####### #######
############## ####### #######
Zdar Zdar Zdar ####### #######
############ #########     ###
###J########           #######
###e############### ##########
###d#####       ### ##########
###no#### #####     Zdar######
####u     ##### ##############
##############################