Bludiste06 Slova se nedotykaji.
############################# 
# # # #a# # # # # # # # # # # 
#      v                    # 
# # # #D# # # # # # # # # # # 
  Jedna irT                 # 
# # # #P# # # # # # # # # # # 
#      e                    # 
# # # #t# # # # # # # # # # # 
#############################
